XXOXXXXXXXX
XXOOXXXXXXX
XXXOOXXXXXX
XXXXOOOXXXX
XXXXOOXXXXX
XXXXOXXXXXX
XXXXOOOXXXX
XXXXXOOOXXX
XXXXOOXXXXX
XXXXOOOXXXX
XXXXXOOXXXX
XXXXXOOXXXX
XXXXXOOXXXX
XXOOOOOXXXX
XXOOXXXXXXX
XXXOOXXXXXX
XXXXOOOXXXX
XXXXOOXXXXX
XXXXOXXXXXX
XXXXOOOXXXX
XXXXXOOOXXX
XXXXOOXXXXX
XXXXOOOXXXX
XXXXXOOXXXX
XXXXXOOXXXX
XXXXXOOXXXX
XXOOOOOXXXX
XXOOXXXXXXX
XXXOOXXXXXX
XXXXOOOXXXX
XXXXOOXXXXX
XXXXOXXXXXX
XXXXOOOXXXX
XXXXXOOOXXX
XXXXOOXXXXX
XXXXOOOXXXX
XXXXXOOXXXX
XXXXXOOXXXX
XXXXXOOXXXX
XXOOOOOXXXX
XXOOXXXXXXX
XXXOOXXXXXX
XXXXOOOXXXX
XXXXOOXXXXX
XXXXOXXXXXX
XXXXOOOXXXX
XXXXXOOOXXX
XXXXOOXXXXX
XXXXOOOXXXX
XXXXXOOXXXX
XXXXXOOXXXX
XXXXXOOXXXX
XXOOOOOXXXX
XXOOXXXXXXX
XXXOOXXXXXX
XXXXOOOXXXX
XXXXOOXXXXX
XXXXOXXXXXX
XXXXOOOXXXX
XXXXXOOOXXX
XXXXOOXXXXX
XXXXOOOXXXX
XXXXXOOXXXX
XXXXXOOXXXX
XXXXXOOXXXX
XXOOOOOXXXX
XXOOXXXXXXX
XXXOOXXXXXX
XXXXOOOXXXX
XXXXOOXXXXX
XXXXOXXXXXX
XXXXOOOXXXX
XXXXXOOOXXX
XXXXOOXXXXX
XXXXOOOXXXX
XXXXXOOXXXX
XXXXXOOXXXX
XXXXXOOXXXX