CCCCCCCCCCC
OOOOOOOOOOO
XXXXOOOXXXX
XXXXOOOXXXX
XXXXOOOXXXX
XXXXOOOXXXX
XXXXOOOXXXX
XOOOOOOXXXX
XOOOOOOXXXX
XXXXOOOOOOX
XXXXOOOOOOX
XXXXXXOOOOX
XXXXXXOOOOX
XXXXOOOOOOX
XXXXOOOOOXX
XXXXOOOOXXX
XXXOOOOXXXX
XXXOOOXXXXX
XXXOOOXXXXX
XXOOOXXXXXX
XXOOOXXXXXX
XXOOOXXXXXX
XXXOOOOXXXX
XXXXOOOXXXX
XXXXOOOXXXX
XXXXOOOXXXX
XXXXOOOXXXX
XXXXOOOXXXX
XOOOOOOXXXX
XOOOOOOXXXX
XXXXOOOXXXX
XXXXOOOOOOX
XXXXXOOOOOX
XXXXXXOOOOX
XXXXOOOOOOX
XXXXOOOOOXX
XXXXOOOOXXX
XXXXOOOXXXX
XXXXOOOXXXX
XXXXOOOXXXX
XXXXOOOXXXX
XXXXOOOXXXX
XXXXXOOOXXX
XXXXXOOOXXX
XXXXOOOXXXX
XXXXOOOXXXX
XXXXOOOXXXX
XXXXOOOXXXX
XXXXOOOXXXX
XXXOOOOXXXX
XXXOOOOXXXX
XXXXOOOOOOX
XXXXOOOOOOX
XXXXXXOOOOX
XXXXXXOOOOX
XXXXOOOOOOX
XXXXOOOOOXX
XXXXOOOOXXX
XXXXOOOXXXX
XXXXOOOXXXX
XXXXOOOXXXX
XXXXOOOXXXX
XXXXOOOXXXX
XXXXOOOXXXX
XXXXOOOXXXX