CCCCC
OOOOO
XOXXX
XOXXX
XOXXX
XOXXX
XOOXX
XOOXX
XXOXX
XXOXX
XXOOX
XXOOX
XXXOX
XXOOX
XXOXX
XXOXX
XXOXX