XXXXOOOXXXX
XOOOOOOXXXX
XOOOOOOXXXX
XXXXOOOOOOX
XXXXOOOOOOX
XXXXXXOOOOX
XXXXXXOOOOX
XXXXOOOOOOX
XXXXOOOOOXX
XXXXOOOOXXX
XXXXOOOXXXX
XXXXOOOXXXX
XXXXOOOXXXX
XXXXOOOXXXX
XXXXOOOXXXX
XXXXOOOXXXX
XXXXOOOXXXX