XXXXOOOXXXX
XOOOOOOXXXX
XOOOOOOXXXX
XXXXOOOOOOX
XXXXOOOOOOX
XXXXXXXOOOX
XXXXXXXOOOX
XXXXOOOOOOX
XXXXOOOOOOX
XXXXOOOXXXX
XXXXOOOXXXX
XXXXOOOXXXX
XXXXOOOXXXX
XXXXOOOXXXX
XXXXOOOXXXX
XXXXOOOXXXX
XXXXOOOXXXX
XXXXOOOXXXX