OXXXX
OOXXX
XOOXX
XXOOX
XXXOX
XXXOX
XXOOX
XXOXX
XXOXX
XXOXX
XXOXX
XXOXX
XXOXX
XXOXX
XXOXX
XXOXX